########
#     F#
# #### #
# #  # #
# ## # #
#    # #
######S#
